0000000000
0M0M00M0M0
0MMM00MMM0
00M0000M00
0000000000
00M0000M00
0MMM00MMM0
0M0M00M0M0
0000000000