00M000000M00
0M0M0000M0M0
M000M00M000M
M0000MM0000M
M0000000000M
MM00M0M00MMM
0M00M0M00M00
00M00M000M00
000M0000M000
000MM00MM000
00000MM00000